1111111111111111111
1100000000C000001E1
1C1000000000e000001
1010000000000000001
10000C0C0C0C0000001
10000C0C0C0C0000001
10000C0C0C0C0000001
10000C0C0P0C0000001
1111111111111111111