1111111111111111111
1100000000C000001E1
1C1e0e00e0000e00001
1010000000000000001
100e0C0C0C0C0000001
10000C0C0C0C0000001
10000C0C0C0C00e0001
100e0C0C0C0C0000001
10000C0C0P0C0000011
100e0C0C0C0C0000001
1e000C0C0C0C00001E1
1111111111111111111